%%%%%%%%%%%%%%
% .        % %
% .        % %
% .        %G%
% .        % %
% .          %
% .        % %
% .        % %
% .   P    %G%
% .        % %
% .        % %
% .        % %
% .        % %
%%%%%%%%%%%%%%